##########
# #   #  #
# ##  #  #
#     #  #
####  #  #
#        #
# ########